/*   FUNCTION KEYS
     -------------------------------------------   -------------------------------------------
     |      |      |      |      |      |      |   |      |  F7  |  F8  |  F9  | F10  |      |
     -------------------------------------------   -------------------------------------------
     |  ▼▼  |      |      |      |      |      |   |      |  F4  |  F5  |  F6  | F11  |      |
     -------------------------------------------   -------------------------------------------
     |      |      |      |      |      |      |   |      |  F1  |  F2  |  F3  | F12  |      |
     -------------------------------------------   -------------------------------------------
                          |      |  ▼▼  |      |   |      |      |      |
                          ----------------------   ----------------------
*/
/*   WINDOW
     -------------------------------------------   -------------------------------------------
     |      |      |      |      |      |      |   |      |  W↖️ |  W⬆️ |  W↗️ |      |      |
     -------------------------------------------   -------------------------------------------
     |      |      |      |      |      |      |   |      |  W⬅️ |  W⏹ |  W➡️ |  W⏪ |      |
     -------------------------------------------   -------------------------------------------
     |      |      |      |      |      |      |   |      |  W↙️ |  W⬇️ |  W↘️ |      |      |
     -------------------------------------------   -------------------------------------------
                          |  ▼▼  |      |      |   |  W🔄 |  W↕️ |  W🔄 |
                          ----------------------   ----------------------
*/
/*   MEDIA
     -------------------------------------------   -------------------------------------------
     |      |      |      | SCRN | SCRN | SCRN |   |      |      |      |      |      |      |
     |      |      |      | CAP1 | CAP2 | INV  |   |      |      |      |      |      |      |
     -------------------------------------------   -------------------------------------------
     | H-A  | H-B  | H-C  | H-D  | H-E  | BRT↑ |   |      |      |      |      |      |      |
     -------------------------------------------   -------------------------------------------
     | H-F  | H-G  | H-H  | H-I  | H-J  | BRT↓ |   |      |      |      |      |      |      |
     -------------------------------------------   -------------------------------------------
                          | VOL↓ | MUTE | VOL↑ |   |      |      |  ▼▼  |
                          ----------------------   ----------------------
*/
/*   NAV
     -------------------------------------------   -------------------------------------------
     |      |      |      |      |      |      |   |      |      |      |      |      |      |
     -------------------------------------------   -------------------------------------------
     |      |   ←  |   ↑  |   ↓  |   →  |      |   |      | CMD  |SHIFT | ALT  | CTRL |      |
     -------------------------------------------   -------------------------------------------
     |      | UNDO | CUT  | COPY |PASTE | REDO |   |      |      |      |      |      |      |
     -------------------------------------------   -------------------------------------------
                          | DEL  | BKSP |  ⏎   |   |      |  ▼▼  |      |
                          ----------------------   ----------------------
*/
/*   MOUSE
     -------------------------------------------   -------------------------------------------
     |      | MS←  | MS↑  | MS↓  | MS→  |      |   |      |      |      |      |      |      |
     -------------------------------------------   -------------------------------------------
     |      |  M←  |  M↑  |  M↓  |  M→  |      |   |      | CMD  |SHIFT | ALT  | CTRL |      |
     -------------------------------------------   -------------------------------------------
     |      | UNDO | CUT  | COPY |PASTE | REDO |   |      |      |      |      |      |      |
     -------------------------------------------   -------------------------------------------
                          |MB-M3 |MB-L1 |MB-R2 |   |  ▼▼  |      |      |
                          ----------------------   ----------------------
*/
/*   NUM
     -------------------------------------------   -------------------------------------------
     |      |      |      |      |      |      |   |  [   |  7   |  8   |  9   |  ]   |      |
     -------------------------------------------   -------------------------------------------
     |FKEYS | CTRL | ALT  |SHIFT | CMD  |      |   |  =   |  4   |  5   |  6   |  ;   |      |
     -------------------------------------------   -------------------------------------------
     |      | UNDO | CUT  | COPY |PASTE | REDO |   |  +   |  1   |  2   |  3   |  `   |      |
     -------------------------------------------   -------------------------------------------
                          |      |  ▼▼  |      |   |  -   |  0   |  .   |
                          ----------------------   ----------------------
*/
/*   BASE
     -------------------------------------------   -------------------------------------------
     |      |      |  W   |  F   |  P   |  G   |   |  J   |  L   |  U   |  Y   | CAPS |      |
     -------------------------------------------   -------------------------------------------
     |  Q   |  A   |  R   |  S   |  T   |  D   |   |  H   |  N   |  E   |  I   |  O   | ' "  |
     |      | CTRL | ALT  | SHIFT| CMD  |      |   |      | CMD  |SHIFT | ALT  | CTRL |      |
     -------------------------------------------   -------------------------------------------
     |  ¿   |  Z   |  X   |  C   |  V   |  B   |   |  K   |  M   |  ,<  |  .>  |  /?  |  ?   |
     -------------------------------------------   -------------------------------------------
                          | DEL  | BKSP |  ⏎   |   |  TAB | [ ]  |  ESC |
                          |WINDOW| NUM  | SYM  |   | MOUSE| NAV  | MEDIA|
                          ----------------------   ----------------------
*/
/*   SYMBOLS
     -------------------------------------------   -------------------------------------------
     |      |      |      |      |      |      |   |  {   |  &   |  *   |  (   |  }   |      |
     -------------------------------------------   -------------------------------------------
     |      | CTRL | ALT  |SHIFT | CMD  |      |   |  \   |  $   |  %   |  ^   |  :   |  ;   |
     -------------------------------------------   -------------------------------------------
     |      |      |      |      |      |      |   |  |   |  !   |  @   |  #   |  ~   |      |
     -------------------------------------------   -------------------------------------------
                          |      |      |  ▼▼  |   |  _   |  (   |  )   |
                          ----------------------   ----------------------
*/
